#########################################################
#.......................................................#
#.......................................................#
#.......................................................#
#.......................................................#
#.......................................................#
#.......................................................#
#.......................................................#
#.......................................................#
#.......................................................#
#..........................@............................#
#.......................................................#
#.......................................................#
#.......................................................#
#.......................................................#
#.......................................................#
#......................................G................#
#.......................................................#
#.......................................................#
#.......................................................#
#.......................................................#
#########################################################